1111111111111
1011C00010001
11P0011011111
1E0C11C000001
1111111111111