1111111111111
10010000100C1
10P0011111001
1E0011C000001
1111110111111