1111111111111
10110000100C1
10P0011011001
1E0011C000001
1111111111111